"filename", "language", "C++", "Markdown", "comment", "blank", "total"
"/home/david/Documents/BlackBoxRadarAttacks/FMCW_radar_uhd/src/Attacker.cpp", "C++", 1, 0, 3, 1, 5
"/home/david/Documents/BlackBoxRadarAttacks/FMCW_radar_uhd/src/Attacker.hpp", "C++", 88, 0, 63, 25, 176
"/home/david/Documents/BlackBoxRadarAttacks/FMCW_radar_uhd/src/BufferHandler.cpp", "C++", 1, 0, 6, 5, 12
"/home/david/Documents/BlackBoxRadarAttacks/FMCW_radar_uhd/src/BufferHandler.hpp", "C++", 823, 0, 539, 200, 1562
"/home/david/Documents/BlackBoxRadarAttacks/FMCW_radar_uhd/src/FMCWHandler.cpp", "C++", 1, 0, 5, 1, 7
"/home/david/Documents/BlackBoxRadarAttacks/FMCW_radar_uhd/src/FMCWHandler.hpp", "C++", 165, 0, 58, 35, 258
"/home/david/Documents/BlackBoxRadarAttacks/FMCW_radar_uhd/src/JSONHandler.cpp", "C++", 33, 0, 0, 7, 40
"/home/david/Documents/BlackBoxRadarAttacks/FMCW_radar_uhd/src/JSONHandler.hpp", "C++", 13, 0, 0, 2, 15
"/home/david/Documents/BlackBoxRadarAttacks/FMCW_radar_uhd/src/RADAR.cpp", "C++", 1, 0, 6, 4, 11
"/home/david/Documents/BlackBoxRadarAttacks/FMCW_radar_uhd/src/RADAR.hpp", "C++", 294, 0, 162, 83, 539
"/home/david/Documents/BlackBoxRadarAttacks/FMCW_radar_uhd/src/USRPHandler.cpp", "C++", 1, 0, 6, 2, 9
"/home/david/Documents/BlackBoxRadarAttacks/FMCW_radar_uhd/src/USRPHandler.hpp", "C++", 939, 0, 301, 180, 1420
"/home/david/Documents/BlackBoxRadarAttacks/FMCW_radar_uhd/src/attacking_subsystem/AttackingSubsystem.cpp", "C++", 1, 0, 3, 1, 5
"/home/david/Documents/BlackBoxRadarAttacks/FMCW_radar_uhd/src/attacking_subsystem/AttackingSubsystem.hpp", "C++", 940, 0, 397, 251, 1588
"/home/david/Documents/BlackBoxRadarAttacks/FMCW_radar_uhd/src/sensing_subsystem/CrossCorr.cpp", "C++", 1, 0, 6, 1, 8
"/home/david/Documents/BlackBoxRadarAttacks/FMCW_radar_uhd/src/sensing_subsystem/CrossCorr.hpp", "C++", 145, 0, 72, 39, 256
"/home/david/Documents/BlackBoxRadarAttacks/FMCW_radar_uhd/src/sensing_subsystem/Eigen/src/Cholesky/LDLT.h", "C++", 410, 0, 188, 91, 689
"/home/david/Documents/BlackBoxRadarAttacks/FMCW_radar_uhd/src/sensing_subsystem/Eigen/src/Cholesky/LLT.h", "C++", 344, 0, 143, 72, 559
"/home/david/Documents/BlackBoxRadarAttacks/FMCW_radar_uhd/src/sensing_subsystem/Eigen/src/Cholesky/LLT_LAPACKE.h", "C++", 59, 0, 31, 10, 100
"/home/david/Documents/BlackBoxRadarAttacks/FMCW_radar_uhd/src/sensing_subsystem/Eigen/src/CholmodSupport/CholmodSupport.h", "C++", 410, 0, 177, 96, 683
"/home/david/Documents/BlackBoxRadarAttacks/FMCW_radar_uhd/src/sensing_subsystem/Eigen/src/Core/ArithmeticSequence.h", "C++", 262, 0, 93, 59, 414
"/home/david/Documents/BlackBoxRadarAttacks/FMCW_radar_uhd/src/sensing_subsystem/Eigen/src/Core/Array.h", "C++", 227, 0, 143, 48, 418
"/home/david/Documents/BlackBoxRadarAttacks/FMCW_radar_uhd/src/sensing_subsystem/Eigen/src/Core/ArrayBase.h", "C++", 137, 0, 59, 31, 227
"/home/david/Documents/BlackBoxRadarAttacks/FMCW_radar_uhd/src/sensing_subsystem/Eigen/src/Core/ArrayWrapper.h", "C++", 138, 0, 38, 34, 210
"/home/david/Documents/BlackBoxRadarAttacks/FMCW_radar_uhd/src/sensing_subsystem/Eigen/src/Core/Assign.h", "C++", 66, 0, 10, 15, 91
"/home/david/Documents/BlackBoxRadarAttacks/FMCW_radar_uhd/src/sensing_subsystem/Eigen/src/Core/AssignEvaluator.h", "C++", 748, 0, 118, 145, 1011
"/home/david/Documents/BlackBoxRadarAttacks/FMCW_radar_uhd/src/sensing_subsystem/Eigen/src/Core/Assign_MKL.h", "C++", 124, 0, 33, 22, 179
"/home/david/Documents/BlackBoxRadarAttacks/FMCW_radar_uhd/src/sensing_subsystem/Eigen/src/Core/BandMatrix.h", "C++", 235, 0, 60, 59, 354
"/home/david/Documents/BlackBoxRadarAttacks/FMCW_radar_uhd/src/sensing_subsystem/Eigen/src/Core/Block.h", "C++", 309, 0, 82, 58, 449
"/home/david/Documents/BlackBoxRadarAttacks/FMCW_radar_uhd/src/sensing_subsystem/Eigen/src/Core/BooleanRedux.h", "C++", 112, 0, 31, 20, 163
"/home/david/Documents/BlackBoxRadarAttacks/FMCW_radar_uhd/src/sensing_subsystem/Eigen/src/Core/CommaInitializer.h", "C++", 102, 0, 47, 16, 165
"/home/david/Documents/BlackBoxRadarAttacks/FMCW_radar_uhd/src/sensing_subsystem/Eigen/src/Core/ConditionEstimator.h", "C++", 95, 0, 66, 15, 176
"/home/david/Documents/BlackBoxRadarAttacks/FMCW_radar_uhd/src/sensing_subsystem/Eigen/src/Core/CoreEvaluators.h", "C++", 1345, 0, 111, 286, 1742
"/home/david/Documents/BlackBoxRadarAttacks/FMCW_radar_uhd/src/sensing_subsystem/Eigen/src/Core/CoreIterators.h", "C++", 76, 0, 32, 25, 133
"/home/david/Documents/BlackBoxRadarAttacks/FMCW_radar_uhd/src/sensing_subsystem/Eigen/src/Core/CwiseBinaryOp.h", "C++", 116, 0, 48, 20, 184
"/home/david/Documents/BlackBoxRadarAttacks/FMCW_radar_uhd/src/sensing_subsystem/Eigen/src/Core/CwiseNullaryOp.h", "C++", 417, 0, 512, 73, 1002
"/home/david/Documents/BlackBoxRadarAttacks/FMCW_radar_uhd/src/sensing_subsystem/Eigen/src/Core/CwiseTernaryOp.h", "C++", 125, 0, 53, 20, 198
"/home/david/Documents/BlackBoxRadarAttacks/FMCW_radar_uhd/src/sensing_subsystem/Eigen/src/Core/CwiseUnaryOp.h", "C++", 56, 0, 32, 16, 104
"/home/david/Documents/BlackBoxRadarAttacks/FMCW_radar_uhd/src/sensing_subsystem/Eigen/src/Core/CwiseUnaryView.h", "C++", 83, 0, 27, 23, 133
"/home/david/Documents/BlackBoxRadarAttacks/FMCW_radar_uhd/src/sensing_subsystem/Eigen/src/Core/DenseBase.h", "C++", 410, 0, 194, 98, 702
"/home/david/Documents/BlackBoxRadarAttacks/FMCW_radar_uhd/src/sensing_subsystem/Eigen/src/Core/DenseCoeffsBase.h", "C++", 368, 0, 232, 86, 686
"/home/david/Documents/BlackBoxRadarAttacks/FMCW_radar_uhd/src/sensing_subsystem/Eigen/src/Core/DenseStorage.h", "C++", 572, 0, 39, 42, 653
"/home/david/Documents/BlackBoxRadarAttacks/FMCW_radar_uhd/src/sensing_subsystem/Eigen/src/Core/Diagonal.h", "C++", 164, 0, 62, 33, 259
"/home/david/Documents/BlackBoxRadarAttacks/FMCW_radar_uhd/src/sensing_subsystem/Eigen/src/Core/DiagonalMatrix.h", "C++", 254, 0, 85, 53, 392
"/home/david/Documents/BlackBoxRadarAttacks/FMCW_radar_uhd/src/sensing_subsystem/Eigen/src/Core/DiagonalProduct.h", "C++", 12, 0, 11, 6, 29
"/home/david/Documents/BlackBoxRadarAttacks/FMCW_radar_uhd/src/sensing_subsystem/Eigen/src/Core/Dot.h", "C++", 181, 0, 108, 30, 319
"/home/david/Documents/BlackBoxRadarAttacks/FMCW_radar_uhd/src/sensing_subsystem/Eigen/src/Core/EigenBase.h", "C++", 80, 0, 60, 21, 161
"/home/david/Documents/BlackBoxRadarAttacks/FMCW_radar_uhd/src/sensing_subsystem/Eigen/src/Core/ForceAlignedAccess.h", "C++", 93, 0, 32, 26, 151
"/home/david/Documents/BlackBoxRadarAttacks/FMCW_radar_uhd/src/sensing_subsystem/Eigen/src/Core/Fuzzy.h", "C++", 90, 0, 49, 17, 156
"/home/david/Documents/BlackBoxRadarAttacks/FMCW_radar_uhd/src/sensing_subsystem/Eigen/src/Core/GeneralProduct.h", "C++", 323, 0, 84, 59, 466
"/home/david/Documents/BlackBoxRadarAttacks/FMCW_radar_uhd/src/sensing_subsystem/Eigen/src/Core/GenericPacketMath.h", "C++", 671, 0, 216, 154, 1041
"/home/david/Documents/BlackBoxRadarAttacks/FMCW_radar_uhd/src/sensing_subsystem/Eigen/src/Core/GlobalFunctions.h", "C++", 132, 0, 47, 16, 195
"/home/david/Documents/BlackBoxRadarAttacks/FMCW_radar_uhd/src/sensing_subsystem/Eigen/src/Core/IO.h", "C++", 166, 0, 70, 23, 259
"/home/david/Documents/BlackBoxRadarAttacks/FMCW_radar_uhd/src/sensing_subsystem/Eigen/src/Core/IndexedView.h", "C++", 134, 0, 55, 49, 238
"/home/david/Documents/BlackBoxRadarAttacks/FMCW_radar_uhd/src/sensing_subsystem/Eigen/src/Core/Inverse.h", "C++", 67, 0, 29, 22, 118
"/home/david/Documents/BlackBoxRadarAttacks/FMCW_radar_uhd/src/sensing_subsystem/Eigen/src/Core/Map.h", "C++", 77, 0, 77, 18, 172
"/home/david/Documents/BlackBoxRadarAttacks/FMCW_radar_uhd/src/sensing_subsystem/Eigen/src/Core/MapBase.h", "C++", 206, 0, 60, 45, 311
"/home/david/Documents/BlackBoxRadarAttacks/FMCW_radar_uhd/src/sensing_subsystem/Eigen/src/Core/MathFunctions.h", "C++", 1604, 0, 163, 291, 2058
"/home/david/Documents/BlackBoxRadarAttacks/FMCW_radar_uhd/src/sensing_subsystem/Eigen/src/Core/MathFunctionsImpl.h", "C++", 104, 0, 74, 23, 201
"/home/david/Documents/BlackBoxRadarAttacks/FMCW_radar_uhd/src/sensing_subsystem/Eigen/src/Core/Matrix.h", "C++", 240, 0, 270, 56, 566
"/home/david/Documents/BlackBoxRadarAttacks/FMCW_radar_uhd/src/sensing_subsystem/Eigen/src/Core/MatrixBase.h", "C++", 351, 0, 103, 94, 548
"/home/david/Documents/BlackBoxRadarAttacks/FMCW_radar_uhd/src/sensing_subsystem/Eigen/src/Core/NestByValue.h", "C++", 45, 0, 24, 17, 86
"/home/david/Documents/BlackBoxRadarAttacks/FMCW_radar_uhd/src/sensing_subsystem/Eigen/src/Core/NoAlias.h", "C++", 46, 0, 51, 13, 110
"/home/david/Documents/BlackBoxRadarAttacks/FMCW_radar_uhd/src/sensing_subsystem/Eigen/src/Core/NumTraits.h", "C++", 224, 0, 67, 45, 336
"/home/david/Documents/BlackBoxRadarAttacks/FMCW_radar_uhd/src/sensing_subsystem/Eigen/src/Core/PartialReduxEvaluator.h", "C++", 151, 0, 46, 36, 233
"/home/david/Documents/BlackBoxRadarAttacks/FMCW_radar_uhd/src/sensing_subsystem/Eigen/src/Core/PermutationMatrix.h", "C++", 372, 0, 149, 85, 606
"/home/david/Documents/BlackBoxRadarAttacks/FMCW_radar_uhd/src/sensing_subsystem/Eigen/src/Core/PlainObjectBase.h", "C++", 758, 0, 259, 112, 1129
"/home/david/Documents/BlackBoxRadarAttacks/FMCW_radar_uhd/src/sensing_subsystem/Eigen/src/Core/Product.h", "C++", 127, 0, 26, 39, 192
"/home/david/Documents/BlackBoxRadarAttacks/FMCW_radar_uhd/src/sensing_subsystem/Eigen/src/Core/ProductEvaluators.h", "C++", 863, 0, 143, 174, 1180
"/home/david/Documents/BlackBoxRadarAttacks/FMCW_radar_uhd/src/sensing_subsystem/Eigen/src/Core/Random.h", "C++", 63, 0, 139, 17, 219
"/home/david/Documents/BlackBoxRadarAttacks/FMCW_radar_uhd/src/sensing_subsystem/Eigen/src/Core/Redux.h", "C++", 370, 0, 82, 64, 516
"/home/david/Documents/BlackBoxRadarAttacks/FMCW_radar_uhd/src/sensing_subsystem/Eigen/src/Core/Ref.h", "C++", 222, 0, 111, 49, 382
"/home/david/Documents/BlackBoxRadarAttacks/FMCW_radar_uhd/src/sensing_subsystem/Eigen/src/Core/Replicate.h", "C++", 85, 0, 42, 16, 143
"/home/david/Documents/BlackBoxRadarAttacks/FMCW_radar_uhd/src/sensing_subsystem/Eigen/src/Core/Reshaped.h", "C++", 310, 0, 73, 72, 455
"/home/david/Documents/BlackBoxRadarAttacks/FMCW_radar_uhd/src/sensing_subsystem/Eigen/src/Core/ReturnByValue.h", "C++", 74, 0, 26, 20, 120
"/home/david/Documents/BlackBoxRadarAttacks/FMCW_radar_uhd/src/sensing_subsystem/Eigen/src/Core/Reverse.h", "C++", 135, 0, 54, 29, 218
"/home/david/Documents/BlackBoxRadarAttacks/FMCW_radar_uhd/src/sensing_subsystem/Eigen/src/Core/Select.h", "C++", 104, 0, 40, 21, 165
"/home/david/Documents/BlackBoxRadarAttacks/FMCW_radar_uhd/src/sensing_subsystem/Eigen/src/Core/SelfAdjointView.h", "C++", 212, 0, 102, 52, 366
"/home/david/Documents/BlackBoxRadarAttacks/FMCW_radar_uhd/src/sensing_subsystem/Eigen/src/Core/SelfCwiseBinaryOp.h", "C++", 29, 0, 9, 10, 48
"/home/david/Documents/BlackBoxRadarAttacks/FMCW_radar_uhd/src/sensing_subsystem/Eigen/src/Core/Solve.h", "C++", 125, 0, 28, 36, 189
"/home/david/Documents/BlackBoxRadarAttacks/FMCW_radar_uhd/src/sensing_subsystem/Eigen/src/Core/SolveTriangular.h", "C++", 168, 0, 20, 48, 236
"/home/david/Documents/BlackBoxRadarAttacks/FMCW_radar_uhd/src/sensing_subsystem/Eigen/src/Core/SolverBase.h", "C++", 94, 0, 48, 27, 169
"/home/david/Documents/BlackBoxRadarAttacks/FMCW_radar_uhd/src/sensing_subsystem/Eigen/src/Core/StableNorm.h", "C++", 180, 0, 42, 30, 252
"/home/david/Documents/BlackBoxRadarAttacks/FMCW_radar_uhd/src/sensing_subsystem/Eigen/src/Core/StlIterators.h", "C++", 339, 0, 32, 93, 464
"/home/david/Documents/BlackBoxRadarAttacks/FMCW_radar_uhd/src/sensing_subsystem/Eigen/src/Core/Stride.h", "C++", 53, 0, 51, 13, 117
"/home/david/Documents/BlackBoxRadarAttacks/FMCW_radar_uhd/src/sensing_subsystem/Eigen/src/Core/Swap.h", "C++", 46, 0, 10, 13, 69
"/home/david/Documents/BlackBoxRadarAttacks/FMCW_radar_uhd/src/sensing_subsystem/Eigen/src/Core/Transpose.h", "C++", 286, 0, 120, 59, 465
"/home/david/Documents/BlackBoxRadarAttacks/FMCW_radar_uhd/src/sensing_subsystem/Eigen/src/Core/Transpositions.h", "C++", 223, 0, 97, 67, 387
"/home/david/Documents/BlackBoxRadarAttacks/FMCW_radar_uhd/src/sensing_subsystem/Eigen/src/Core/TriangularMatrix.h", "C++", 670, 0, 185, 147, 1002
"/home/david/Documents/BlackBoxRadarAttacks/FMCW_radar_uhd/src/sensing_subsystem/Eigen/src/Core/VectorBlock.h", "C++", 43, 0, 43, 11, 97
"/home/david/Documents/BlackBoxRadarAttacks/FMCW_radar_uhd/src/sensing_subsystem/Eigen/src/Core/VectorwiseOp.h", "C++", 437, 0, 255, 93, 785
"/home/david/Documents/BlackBoxRadarAttacks/FMCW_radar_uhd/src/sensing_subsystem/Eigen/src/Core/Visitor.h", "C++", 258, 0, 85, 39, 382
"/home/david/Documents/BlackBoxRadarAttacks/FMCW_radar_uhd/src/sensing_subsystem/Eigen/src/Core/arch/AVX/Complex.h", "C++", 302, 0, 13, 58, 373
"/home/david/Documents/BlackBoxRadarAttacks/FMCW_radar_uhd/src/sensing_subsystem/Eigen/src/Core/arch/AVX/MathFunctions.h", "C++", 151, 0, 39, 39, 229
"/home/david/Documents/BlackBoxRadarAttacks/FMCW_radar_uhd/src/sensing_subsystem/Eigen/src/Core/arch/AVX/PacketMath.h", "C++", 1277, 0, 92, 206, 1575
"/home/david/Documents/BlackBoxRadarAttacks/FMCW_radar_uhd/src/sensing_subsystem/Eigen/src/Core/arch/AVX/TypeCasting.h", "C++", 81, 0, 10, 25, 116
"/home/david/Documents/BlackBoxRadarAttacks/FMCW_radar_uhd/src/sensing_subsystem/Eigen/src/Core/arch/AVX512/Complex.h", "C++", 349, 0, 10, 64, 423
"/home/david/Documents/BlackBoxRadarAttacks/FMCW_radar_uhd/src/sensing_subsystem/Eigen/src/Core/arch/AVX512/MathFunctions.h", "C++", 236, 0, 55, 72, 363
"/home/david/Documents/BlackBoxRadarAttacks/FMCW_radar_uhd/src/sensing_subsystem/Eigen/src/Core/arch/AVX512/PacketMath.h", "C++", 1957, 0, 84, 263, 2304
"/home/david/Documents/BlackBoxRadarAttacks/FMCW_radar_uhd/src/sensing_subsystem/Eigen/src/Core/arch/AVX512/TypeCasting.h", "C++", 63, 0, 8, 19, 90
"/home/david/Documents/BlackBoxRadarAttacks/FMCW_radar_uhd/src/sensing_subsystem/Eigen/src/Core/arch/AltiVec/Complex.h", "C++", 324, 0, 27, 67, 418
"/home/david/Documents/BlackBoxRadarAttacks/FMCW_radar_uhd/src/sensing_subsystem/Eigen/src/Core/arch/AltiVec/MathFunctions.h", "C++", 63, 0, 11, 17, 91
"/home/david/Documents/BlackBoxRadarAttacks/FMCW_radar_uhd/src/sensing_subsystem/Eigen/src/Core/arch/AltiVec/MatrixProduct.h", "C++", 2489, 0, 85, 364, 2938
"/home/david/Documents/BlackBoxRadarAttacks/FMCW_radar_uhd/src/sensing_subsystem/Eigen/src/Core/arch/AltiVec/MatrixProductCommon.h", "C++", 182, 0, 5, 35, 222
"/home/david/Documents/BlackBoxRadarAttacks/FMCW_radar_uhd/src/sensing_subsystem/Eigen/src/Core/arch/AltiVec/MatrixProductMMA.h", "C++", 521, 0, 15, 94, 630
"/home/david/Documents/BlackBoxRadarAttacks/FMCW_radar_uhd/src/sensing_subsystem/Eigen/src/Core/arch/AltiVec/PacketMath.h", "C++", 2252, 0, 78, 382, 2712
"/home/david/Documents/BlackBoxRadarAttacks/FMCW_radar_uhd/src/sensing_subsystem/Eigen/src/Core/arch/CUDA/Complex.h", "C++", 202, 0, 33, 24, 259
"/home/david/Documents/BlackBoxRadarAttacks/FMCW_radar_uhd/src/sensing_subsystem/Eigen/src/Core/arch/Default/BFloat16.h", "C++", 443, 0, 195, 63, 701
"/home/david/Documents/BlackBoxRadarAttacks/FMCW_radar_uhd/src/sensing_subsystem/Eigen/src/Core/arch/Default/ConjHelper.h", "C++", 84, 0, 13, 21, 118
"/home/david/Documents/BlackBoxRadarAttacks/FMCW_radar_uhd/src/sensing_subsystem/Eigen/src/Core/arch/Default/GenericPacketMathFunctions.h", "C++", 917, 0, 560, 173, 1650
"/home/david/Documents/BlackBoxRadarAttacks/FMCW_radar_uhd/src/sensing_subsystem/Eigen/src/Core/arch/Default/GenericPacketMathFunctionsFwd.h", "C++", 54, 0, 34, 23, 111
"/home/david/Documents/BlackBoxRadarAttacks/FMCW_radar_uhd/src/sensing_subsystem/Eigen/src/Core/arch/Default/Half.h", "C++", 700, 0, 139, 104, 943
"/home/david/Documents/BlackBoxRadarAttacks/FMCW_radar_uhd/src/sensing_subsystem/Eigen/src/Core/arch/Default/Settings.h", "C++", 15, 0, 25, 10, 50
"/home/david/Documents/BlackBoxRadarAttacks/FMCW_radar_uhd/src/sensing_subsystem/Eigen/src/Core/arch/Default/TypeCasting.h", "C++", 88, 0, 9, 24, 121
"/home/david/Documents/BlackBoxRadarAttacks/FMCW_radar_uhd/src/sensing_subsystem/Eigen/src/Core/arch/GPU/MathFunctions.h", "C++", 72, 0, 11, 21, 104
"/home/david/Documents/BlackBoxRadarAttacks/FMCW_radar_uhd/src/sensing_subsystem/Eigen/src/Core/arch/GPU/PacketMath.h", "C++", 1461, 0, 28, 197, 1686
"/home/david/Documents/BlackBoxRadarAttacks/FMCW_radar_uhd/src/sensing_subsystem/Eigen/src/Core/arch/GPU/TypeCasting.h", "C++", 54, 0, 10, 17, 81
"/home/david/Documents/BlackBoxRadarAttacks/FMCW_radar_uhd/src/sensing_subsystem/Eigen/src/Core/arch/HIP/hcc/math_constants.h", "C++", 12, 0, 6, 6, 24
"/home/david/Documents/BlackBoxRadarAttacks/FMCW_radar_uhd/src/sensing_subsystem/Eigen/src/Core/arch/MSA/Complex.h", "C++", 491, 0, 28, 130, 649
"/home/david/Documents/BlackBoxRadarAttacks/FMCW_radar_uhd/src/sensing_subsystem/Eigen/src/Core/arch/MSA/MathFunctions.h", "C++", 239, 0, 86, 63, 388
"/home/david/Documents/BlackBoxRadarAttacks/FMCW_radar_uhd/src/sensing_subsystem/Eigen/src/Core/arch/MSA/PacketMath.h", "C++", 941, 0, 48, 245, 1234
"/home/david/Documents/BlackBoxRadarAttacks/FMCW_radar_uhd/src/sensing_subsystem/Eigen/src/Core/arch/NEON/Complex.h", "C++", 433, 0, 62, 90, 585
"/home/david/Documents/BlackBoxRadarAttacks/FMCW_radar_uhd/src/sensing_subsystem/Eigen/src/Core/arch/NEON/GeneralBlockPanelKernel.h", "C++", 140, 0, 13, 31, 184
"/home/david/Documents/BlackBoxRadarAttacks/FMCW_radar_uhd/src/sensing_subsystem/Eigen/src/Core/arch/NEON/MathFunctions.h", "C++", 49, 0, 8, 19, 76
"/home/david/Documents/BlackBoxRadarAttacks/FMCW_radar_uhd/src/sensing_subsystem/Eigen/src/Core/arch/NEON/PacketMath.h", "C++", 4063, 0, 120, 405, 4588
"/home/david/Documents/BlackBoxRadarAttacks/FMCW_radar_uhd/src/sensing_subsystem/Eigen/src/Core/arch/NEON/TypeCasting.h", "C++", 1222, 0, 80, 118, 1420
"/home/david/Documents/BlackBoxRadarAttacks/FMCW_radar_uhd/src/sensing_subsystem/Eigen/src/Core/arch/SSE/Complex.h", "C++", 273, 0, 23, 56, 352
"/home/david/Documents/BlackBoxRadarAttacks/FMCW_radar_uhd/src/sensing_subsystem/Eigen/src/Core/arch/SSE/MathFunctions.h", "C++", 120, 0, 38, 42, 200
"/home/david/Documents/BlackBoxRadarAttacks/FMCW_radar_uhd/src/sensing_subsystem/Eigen/src/Core/arch/SSE/PacketMath.h", "C++", 1204, 0, 131, 171, 1506
"/home/david/Documents/BlackBoxRadarAttacks/FMCW_radar_uhd/src/sensing_subsystem/Eigen/src/Core/arch/SSE/TypeCasting.h", "C++", 106, 0, 11, 26, 143
"/home/david/Documents/BlackBoxRadarAttacks/FMCW_radar_uhd/src/sensing_subsystem/Eigen/src/Core/arch/SVE/MathFunctions.h", "C++", 27, 0, 9, 9, 45
"/home/david/Documents/BlackBoxRadarAttacks/FMCW_radar_uhd/src/sensing_subsystem/Eigen/src/Core/arch/SVE/PacketMath.h", "C++", 603, 0, 35, 115, 753
"/home/david/Documents/BlackBoxRadarAttacks/FMCW_radar_uhd/src/sensing_subsystem/Eigen/src/Core/arch/SVE/TypeCasting.h", "C++", 31, 0, 8, 11, 50
"/home/david/Documents/BlackBoxRadarAttacks/FMCW_radar_uhd/src/sensing_subsystem/Eigen/src/Core/arch/SYCL/InteropHeaders.h", "C++", 181, 0, 28, 24, 233
"/home/david/Documents/BlackBoxRadarAttacks/FMCW_radar_uhd/src/sensing_subsystem/Eigen/src/Core/arch/SYCL/MathFunctions.h", "C++", 219, 0, 30, 53, 302
"/home/david/Documents/BlackBoxRadarAttacks/FMCW_radar_uhd/src/sensing_subsystem/Eigen/src/Core/arch/SYCL/PacketMath.h", "C++", 541, 0, 34, 96, 671
"/home/david/Documents/BlackBoxRadarAttacks/FMCW_radar_uhd/src/sensing_subsystem/Eigen/src/Core/arch/SYCL/SyclMemoryModel.h", "C++", 380, 0, 227, 88, 695
"/home/david/Documents/BlackBoxRadarAttacks/FMCW_radar_uhd/src/sensing_subsystem/Eigen/src/Core/arch/SYCL/TypeCasting.h", "C++", 52, 0, 19, 15, 86
"/home/david/Documents/BlackBoxRadarAttacks/FMCW_radar_uhd/src/sensing_subsystem/Eigen/src/Core/arch/ZVector/Complex.h", "C++", 336, 0, 24, 67, 427
"/home/david/Documents/BlackBoxRadarAttacks/FMCW_radar_uhd/src/sensing_subsystem/Eigen/src/Core/arch/ZVector/MathFunctions.h", "C++", 159, 0, 26, 49, 234
"/home/david/Documents/BlackBoxRadarAttacks/FMCW_radar_uhd/src/sensing_subsystem/Eigen/src/Core/arch/ZVector/PacketMath.h", "C++", 851, 0, 52, 158, 1061
"/home/david/Documents/BlackBoxRadarAttacks/FMCW_radar_uhd/src/sensing_subsystem/Eigen/src/Core/functors/AssignmentFunctors.h", "C++", 103, 0, 49, 26, 178
"/home/david/Documents/BlackBoxRadarAttacks/FMCW_radar_uhd/src/sensing_subsystem/Eigen/src/Core/functors/BinaryFunctors.h", "C++", 388, 0, 92, 62, 542
"/home/david/Documents/BlackBoxRadarAttacks/FMCW_radar_uhd/src/sensing_subsystem/Eigen/src/Core/functors/NullaryFunctors.h", "C++", 140, 0, 22, 28, 190
"/home/david/Documents/BlackBoxRadarAttacks/FMCW_radar_uhd/src/sensing_subsystem/Eigen/src/Core/functors/StlFunctors.h", "C++", 110, 0, 15, 42, 167
"/home/david/Documents/BlackBoxRadarAttacks/FMCW_radar_uhd/src/sensing_subsystem/Eigen/src/Core/functors/TernaryFunctors.h", "C++", 7, 0, 9, 10, 26
"/home/david/Documents/BlackBoxRadarAttacks/FMCW_radar_uhd/src/sensing_subsystem/Eigen/src/Core/functors/UnaryFunctors.h", "C++", 778, 0, 277, 77, 1132
"/home/david/Documents/BlackBoxRadarAttacks/FMCW_radar_uhd/src/sensing_subsystem/Eigen/src/Core/products/GeneralBlockPanelKernel.h", "C++", 1971, 0, 367, 308, 2646
"/home/david/Documents/BlackBoxRadarAttacks/FMCW_radar_uhd/src/sensing_subsystem/Eigen/src/Core/products/GeneralMatrixMatrix.h", "C++", 373, 0, 54, 91, 518
"/home/david/Documents/BlackBoxRadarAttacks/FMCW_radar_uhd/src/sensing_subsystem/Eigen/src/Core/products/GeneralMatrixMatrixTriangular.h", "C++", 221, 0, 38, 59, 318
"/home/david/Documents/BlackBoxRadarAttacks/FMCW_radar_uhd/src/sensing_subsystem/Eigen/src/Core/products/GeneralMatrixMatrixTriangular_BLAS.h", "C++", 90, 0, 40, 16, 146
"/home/david/Documents/BlackBoxRadarAttacks/FMCW_radar_uhd/src/sensing_subsystem/Eigen/src/Core/products/GeneralMatrixMatrix_BLAS.h", "C++", 76, 0, 38, 11, 125
"/home/david/Documents/BlackBoxRadarAttacks/FMCW_radar_uhd/src/sensing_subsystem/Eigen/src/Core/products/GeneralMatrixVector.h", "C++", 423, 0, 40, 56, 519
"/home/david/Documents/BlackBoxRadarAttacks/FMCW_radar_uhd/src/sensing_subsystem/Eigen/src/Core/products/GeneralMatrixVector_BLAS.h", "C++", 85, 0, 38, 14, 137
"/home/david/Documents/BlackBoxRadarAttacks/FMCW_radar_uhd/src/sensing_subsystem/Eigen/src/Core/products/Parallelizer.h", "C++", 108, 0, 40, 33, 181
"/home/david/Documents/BlackBoxRadarAttacks/FMCW_radar_uhd/src/sensing_subsystem/Eigen/src/Core/products/SelfadjointMatrixMatrix.h", "C++", 423, 0, 51, 71, 545
"/home/david/Documents/BlackBoxRadarAttacks/FMCW_radar_uhd/src/sensing_subsystem/Eigen/src/Core/products/SelfadjointMatrixMatrix_BLAS.h", "C++", 246, 0, 33, 17, 296
"/home/david/Documents/BlackBoxRadarAttacks/FMCW_radar_uhd/src/sensing_subsystem/Eigen/src/Core/products/SelfadjointMatrixVector.h", "C++", 196, 0, 19, 48, 263
"/home/david/Documents/BlackBoxRadarAttacks/FMCW_radar_uhd/src/sensing_subsystem/Eigen/src/Core/products/SelfadjointMatrixVector_BLAS.h", "C++", 70, 0, 35, 14, 119
"/home/david/Documents/BlackBoxRadarAttacks/FMCW_radar_uhd/src/sensing_subsystem/Eigen/src/Core/products/SelfadjointProduct.h", "C++", 93, 0, 14, 27, 134
"/home/david/Documents/BlackBoxRadarAttacks/FMCW_radar_uhd/src/sensing_subsystem/Eigen/src/Core/products/SelfadjointRank2Update.h", "C++", 64, 0, 13, 18, 95
"/home/david/Documents/BlackBoxRadarAttacks/FMCW_radar_uhd/src/sensing_subsystem/Eigen/src/Core/products/TriangularMatrixMatrix.h", "C++", 342, 0, 69, 62, 473
"/home/david/Documents/BlackBoxRadarAttacks/FMCW_radar_uhd/src/sensing_subsystem/Eigen/src/Core/products/TriangularMatrixMatrix_BLAS.h", "C++", 269, 0, 34, 15, 318
"/home/david/Documents/BlackBoxRadarAttacks/FMCW_radar_uhd/src/sensing_subsystem/Eigen/src/Core/products/TriangularMatrixVector.h", "C++", 280, 0, 14, 57, 351
"/home/david/Documents/BlackBoxRadarAttacks/FMCW_radar_uhd/src/sensing_subsystem/Eigen/src/Core/products/TriangularMatrixVector_BLAS.h", "C++", 203, 0, 37, 16, 256
"/home/david/Documents/BlackBoxRadarAttacks/FMCW_radar_uhd/src/sensing_subsystem/Eigen/src/Core/products/TriangularSolverMatrix.h", "C++", 250, 0, 40, 48, 338
"/home/david/Documents/BlackBoxRadarAttacks/FMCW_radar_uhd/src/sensing_subsystem/Eigen/src/Core/products/TriangularSolverMatrix_BLAS.h", "C++", 124, 0, 33, 11, 168
"/home/david/Documents/BlackBoxRadarAttacks/FMCW_radar_uhd/src/sensing_subsystem/Eigen/src/Core/products/TriangularSolverVector.h", "C++", 114, 0, 16, 19, 149
"/home/david/Documents/BlackBoxRadarAttacks/FMCW_radar_uhd/src/sensing_subsystem/Eigen/src/Core/util/BlasUtil.h", "C++", 467, 0, 34, 83, 584
"/home/david/Documents/BlackBoxRadarAttacks/FMCW_radar_uhd/src/sensing_subsystem/Eigen/src/Core/util/ConfigureVectorization.h", "C++", 335, 0, 112, 66, 513
"/home/david/Documents/BlackBoxRadarAttacks/FMCW_radar_uhd/src/sensing_subsystem/Eigen/src/Core/util/Constants.h", "C++", 214, 0, 291, 59, 564
"/home/david/Documents/BlackBoxRadarAttacks/FMCW_radar_uhd/src/sensing_subsystem/Eigen/src/Core/util/DisableStupidWarnings.h", "C++", 65, 0, 33, 9, 107
"/home/david/Documents/BlackBoxRadarAttacks/FMCW_radar_uhd/src/sensing_subsystem/Eigen/src/Core/util/ForwardDeclarations.h", "C++", 242, 0, 37, 44, 323
"/home/david/Documents/BlackBoxRadarAttacks/FMCW_radar_uhd/src/sensing_subsystem/Eigen/src/Core/util/IndexedViewHelper.h", "C++", 91, 0, 60, 36, 187
"/home/david/Documents/BlackBoxRadarAttacks/FMCW_radar_uhd/src/sensing_subsystem/Eigen/src/Core/util/IntegralConstant.h", "C++", 103, 0, 136, 34, 273
"/home/david/Documents/BlackBoxRadarAttacks/FMCW_radar_uhd/src/sensing_subsystem/Eigen/src/Core/util/MKL_support.h", "C++", 82, 0, 35, 21, 138
"/home/david/Documents/BlackBoxRadarAttacks/FMCW_radar_uhd/src/sensing_subsystem/Eigen/src/Core/util/Macros.h", "C++", 900, 0, 367, 198, 1465
"/home/david/Documents/BlackBoxRadarAttacks/FMCW_radar_uhd/src/sensing_subsystem/Eigen/src/Core/util/Memory.h", "C++", 802, 0, 224, 138, 1164
"/home/david/Documents/BlackBoxRadarAttacks/FMCW_radar_uhd/src/sensing_subsystem/Eigen/src/Core/util/Meta.h", "C++", 590, 0, 103, 120, 813
"/home/david/Documents/BlackBoxRadarAttacks/FMCW_radar_uhd/src/sensing_subsystem/Eigen/src/Core/util/NonMPL2.h", "C++", 3, 0, 0, 1, 4
"/home/david/Documents/BlackBoxRadarAttacks/FMCW_radar_uhd/src/sensing_subsystem/Eigen/src/Core/util/ReenableStupidWarnings.h", "C++", 18, 0, 8, 6, 32
"/home/david/Documents/BlackBoxRadarAttacks/FMCW_radar_uhd/src/sensing_subsystem/Eigen/src/Core/util/ReshapedHelper.h", "C++", 30, 0, 8, 14, 52
"/home/david/Documents/BlackBoxRadarAttacks/FMCW_radar_uhd/src/sensing_subsystem/Eigen/src/Core/util/StaticAssert.h", "C++", 150, 0, 35, 37, 222
"/home/david/Documents/BlackBoxRadarAttacks/FMCW_radar_uhd/src/sensing_subsystem/Eigen/src/Core/util/SymbolicIndex.h", "C++", 190, 0, 62, 42, 294
"/home/david/Documents/BlackBoxRadarAttacks/FMCW_radar_uhd/src/sensing_subsystem/Eigen/src/Core/util/XprHelper.h", "C++", 573, 0, 165, 119, 857
"/home/david/Documents/BlackBoxRadarAttacks/FMCW_radar_uhd/src/sensing_subsystem/Eigen/src/Eigenvalues/ComplexEigenSolver.h", "C++", 156, 0, 152, 39, 347
"/home/david/Documents/BlackBoxRadarAttacks/FMCW_radar_uhd/src/sensing_subsystem/Eigen/src/Eigenvalues/ComplexSchur.h", "C++", 233, 0, 181, 49, 463
"/home/david/Documents/BlackBoxRadarAttacks/FMCW_radar_uhd/src/sensing_subsystem/Eigen/src/Eigenvalues/ComplexSchur_LAPACKE.h", "C++", 52, 0, 32, 8, 92
"/home/david/Documents/BlackBoxRadarAttacks/FMCW_radar_uhd/src/sensing_subsystem/Eigen/src/Eigenvalues/EigenSolver.h", "C++", 345, 0, 221, 57, 623
"/home/david/Documents/BlackBoxRadarAttacks/FMCW_radar_uhd/src/sensing_subsystem/Eigen/src/Eigenvalues/GeneralizedEigenSolver.h", "C++", 202, 0, 180, 37, 419
"/home/david/Documents/BlackBoxRadarAttacks/FMCW_radar_uhd/src/sensing_subsystem/Eigen/src/Eigenvalues/GeneralizedSelfAdjointEigenSolver.h", "C++", 70, 0, 130, 27, 227
"/home/david/Documents/BlackBoxRadarAttacks/FMCW_radar_uhd/src/sensing_subsystem/Eigen/src/Eigenvalues/HessenbergDecomposition.h", "C++", 138, 0, 202, 35, 375
"/home/david/Documents/BlackBoxRadarAttacks/FMCW_radar_uhd/src/sensing_subsystem/Eigen/src/Eigenvalues/MatrixBaseEigenvalues.h", "C++", 61, 0, 83, 15, 159
"/home/david/Documents/BlackBoxRadarAttacks/FMCW_radar_uhd/src/sensing_subsystem/Eigen/src/Eigenvalues/RealQZ.h", "C++", 435, 0, 162, 61, 658
"/home/david/Documents/BlackBoxRadarAttacks/FMCW_radar_uhd/src/sensing_subsystem/Eigen/src/Eigenvalues/RealSchur.h", "C++", 335, 0, 165, 59, 559
"/home/david/Documents/BlackBoxRadarAttacks/FMCW_radar_uhd/src/sensing_subsystem/Eigen/src/Eigenvalues/RealSchur_LAPACKE.h", "C++", 38, 0, 32, 8, 78
"/home/david/Documents/BlackBoxRadarAttacks/FMCW_radar_uhd/src/sensing_subsystem/Eigen/src/Eigenvalues/SelfAdjointEigenSolver.h", "C++", 476, 0, 333, 96, 905
"/home/david/Documents/BlackBoxRadarAttacks/FMCW_radar_uhd/src/sensing_subsystem/Eigen/src/Eigenvalues/SelfAdjointEigenSolver_LAPACKE.h", "C++", 47, 0, 32, 9, 88
"/home/david/Documents/BlackBoxRadarAttacks/FMCW_radar_uhd/src/sensing_subsystem/Eigen/src/Eigenvalues/Tridiagonalization.h", "C++", 242, 0, 271, 49, 562
"/home/david/Documents/BlackBoxRadarAttacks/FMCW_radar_uhd/src/sensing_subsystem/Eigen/src/Geometry/AlignedBox.h", "C++", 242, 0, 181, 64, 487
"/home/david/Documents/BlackBoxRadarAttacks/FMCW_radar_uhd/src/sensing_subsystem/Eigen/src/Geometry/AngleAxis.h", "C++", 126, 0, 84, 38, 248
"/home/david/Documents/BlackBoxRadarAttacks/FMCW_radar_uhd/src/sensing_subsystem/Eigen/src/Geometry/EulerAngles.h", "C++", 65, 0, 38, 12, 115
"/home/david/Documents/BlackBoxRadarAttacks/FMCW_radar_uhd/src/sensing_subsystem/Eigen/src/Geometry/Homogeneous.h", "C++", 359, 0, 82, 61, 502
"/home/david/Documents/BlackBoxRadarAttacks/FMCW_radar_uhd/src/sensing_subsystem/Eigen/src/Geometry/Hyperplane.h", "C++", 144, 0, 105, 34, 283
"/home/david/Documents/BlackBoxRadarAttacks/FMCW_radar_uhd/src/sensing_subsystem/Eigen/src/Geometry/OrthoMethods.h", "C++", 152, 0, 59, 25, 236
"/home/david/Documents/BlackBoxRadarAttacks/FMCW_radar_uhd/src/sensing_subsystem/Eigen/src/Geometry/ParametrizedLine.h", "C++", 125, 0, 73, 35, 233
"/home/david/Documents/BlackBoxRadarAttacks/FMCW_radar_uhd/src/sensing_subsystem/Eigen/src/Geometry/Quaternion.h", "C++", 475, 0, 272, 124, 871
"/home/david/Documents/BlackBoxRadarAttacks/FMCW_radar_uhd/src/sensing_subsystem/Eigen/src/Geometry/Rotation2D.h", "C++", 94, 0, 69, 37, 200
"/home/david/Documents/BlackBoxRadarAttacks/FMCW_radar_uhd/src/sensing_subsystem/Eigen/src/Geometry/RotationBase.h", "C++", 115, 0, 61, 31, 207
"/home/david/Documents/BlackBoxRadarAttacks/FMCW_radar_uhd/src/sensing_subsystem/Eigen/src/Geometry/Scaling.h", "C++", 93, 0, 66, 30, 189
"/home/david/Documents/BlackBoxRadarAttacks/FMCW_radar_uhd/src/sensing_subsystem/Eigen/src/Geometry/Transform.h", "C++", 950, 0, 448, 166, 1564
"/home/david/Documents/BlackBoxRadarAttacks/FMCW_radar_uhd/src/sensing_subsystem/Eigen/src/Geometry/Translation.h", "C++", 113, 0, 60, 30, 203
"/home/david/Documents/BlackBoxRadarAttacks/FMCW_radar_uhd/src/sensing_subsystem/Eigen/src/Geometry/Umeyama.h", "C++", 67, 0, 69, 31, 167
"/home/david/Documents/BlackBoxRadarAttacks/FMCW_radar_uhd/src/sensing_subsystem/Eigen/src/Geometry/arch/Geometry_SIMD.h", "C++", 124, 0, 20, 25, 169
"/home/david/Documents/BlackBoxRadarAttacks/FMCW_radar_uhd/src/sensing_subsystem/Eigen/src/Householder/BlockHouseholder.h", "C++", 47, 0, 47, 17, 111
"/home/david/Documents/BlackBoxRadarAttacks/FMCW_radar_uhd/src/sensing_subsystem/Eigen/src/Householder/Householder.h", "C++", 94, 0, 70, 13, 177
"/home/david/Documents/BlackBoxRadarAttacks/FMCW_radar_uhd/src/sensing_subsystem/Eigen/src/Householder/HouseholderSequence.h", "C++", 330, 0, 163, 53, 546
"/home/david/Documents/BlackBoxRadarAttacks/FMCW_radar_uhd/src/sensing_subsystem/Eigen/src/IterativeLinearSolvers/BasicPreconditioners.h", "C++", 141, 0, 54, 32, 227
"/home/david/Documents/BlackBoxRadarAttacks/FMCW_radar_uhd/src/sensing_subsystem/Eigen/src/IterativeLinearSolvers/BiCGSTAB.h", "C++", 115, 0, 64, 34, 213
"/home/david/Documents/BlackBoxRadarAttacks/FMCW_radar_uhd/src/sensing_subsystem/Eigen/src/IterativeLinearSolvers/ConjugateGradient.h", "C++", 121, 0, 76, 33, 230
"/home/david/Documents/BlackBoxRadarAttacks/FMCW_radar_uhd/src/sensing_subsystem/Eigen/src/IterativeLinearSolvers/IncompleteCholesky.h", "C++", 250, 0, 101, 44, 395
"/home/david/Documents/BlackBoxRadarAttacks/FMCW_radar_uhd/src/sensing_subsystem/Eigen/src/IterativeLinearSolvers/IncompleteLUT.h", "C++", 293, 0, 105, 56, 454
"/home/david/Documents/BlackBoxRadarAttacks/FMCW_radar_uhd/src/sensing_subsystem/Eigen/src/IterativeLinearSolvers/IterativeSolverBase.h", "C++", 293, 0, 87, 65, 445
"/home/david/Documents/BlackBoxRadarAttacks/FMCW_radar_uhd/src/sensing_subsystem/Eigen/src/IterativeLinearSolvers/LeastSquareConjugateGradient.h", "C++", 103, 0, 66, 30, 199
"/home/david/Documents/BlackBoxRadarAttacks/FMCW_radar_uhd/src/sensing_subsystem/Eigen/src/IterativeLinearSolvers/SolveWithGuess.h", "C++", 71, 0, 23, 24, 118
"/home/david/Documents/BlackBoxRadarAttacks/FMCW_radar_uhd/src/sensing_subsystem/Eigen/src/Jacobi/Jacobi.h", "C++", 344, 0, 89, 51, 484
"/home/david/Documents/BlackBoxRadarAttacks/FMCW_radar_uhd/src/sensing_subsystem/Eigen/src/KLUSupport/KLUSupport.h", "C++", 237, 0, 60, 62, 359
"/home/david/Documents/BlackBoxRadarAttacks/FMCW_radar_uhd/src/sensing_subsystem/Eigen/src/LU/Determinant.h", "C++", 91, 0, 12, 15, 118
"/home/david/Documents/BlackBoxRadarAttacks/FMCW_radar_uhd/src/sensing_subsystem/Eigen/src/LU/FullPivLU.h", "C++", 448, 0, 320, 110, 878
"/home/david/Documents/BlackBoxRadarAttacks/FMCW_radar_uhd/src/sensing_subsystem/Eigen/src/LU/InverseImpl.h", "C++", 304, 0, 89, 40, 433
"/home/david/Documents/BlackBoxRadarAttacks/FMCW_radar_uhd/src/sensing_subsystem/Eigen/src/LU/PartialPivLU.h", "C++", 336, 0, 207, 82, 625
"/home/david/Documents/BlackBoxRadarAttacks/FMCW_radar_uhd/src/sensing_subsystem/Eigen/src/LU/PartialPivLU_LAPACKE.h", "C++", 42, 0, 32, 10, 84
"/home/david/Documents/BlackBoxRadarAttacks/FMCW_radar_uhd/src/sensing_subsystem/Eigen/src/LU/arch/InverseSize4.h", "C++", 231, 0, 65, 56, 352
"/home/david/Documents/BlackBoxRadarAttacks/FMCW_radar_uhd/src/sensing_subsystem/Eigen/src/MetisSupport/MetisSupport.h", "C++", 94, 0, 31, 13, 138
"/home/david/Documents/BlackBoxRadarAttacks/FMCW_radar_uhd/src/sensing_subsystem/Eigen/src/OrderingMethods/Amd.h", "C++", 365, 0, 40, 31, 436
"/home/david/Documents/BlackBoxRadarAttacks/FMCW_radar_uhd/src/sensing_subsystem/Eigen/src/OrderingMethods/Eigen_Colamd.h", "C++", 1087, 0, 481, 296, 1864
"/home/david/Documents/BlackBoxRadarAttacks/FMCW_radar_uhd/src/sensing_subsystem/Eigen/src/OrderingMethods/Ordering.h", "C++", 77, 0, 54, 23, 154
"/home/david/Documents/BlackBoxRadarAttacks/FMCW_radar_uhd/src/sensing_subsystem/Eigen/src/PaStiXSupport/PaStiXSupport.h", "C++", 440, 0, 151, 88, 679
"/home/david/Documents/BlackBoxRadarAttacks/FMCW_radar_uhd/src/sensing_subsystem/Eigen/src/PardisoSupport/PardisoSupport.h", "C++", 354, 0, 121, 71, 546
"/home/david/Documents/BlackBoxRadarAttacks/FMCW_radar_uhd/src/sensing_subsystem/Eigen/src/QR/ColPivHouseholderQR.h", "C++", 357, 0, 232, 86, 675
"/home/david/Documents/BlackBoxRadarAttacks/FMCW_radar_uhd/src/sensing_subsystem/Eigen/src/QR/ColPivHouseholderQR_LAPACKE.h", "C++", 56, 0, 33, 9, 98
"/home/david/Documents/BlackBoxRadarAttacks/FMCW_radar_uhd/src/sensing_subsystem/Eigen/src/QR/CompleteOrthogonalDecomposition.h", "C++", 302, 0, 261, 73, 636
"/home/david/Documents/BlackBoxRadarAttacks/FMCW_radar_uhd/src/sensing_subsystem/Eigen/src/QR/FullPivHouseholderQR.h", "C++", 407, 0, 216, 91, 714
"/home/david/Documents/BlackBoxRadarAttacks/FMCW_radar_uhd/src/sensing_subsystem/Eigen/src/QR/HouseholderQR.h", "C++", 227, 0, 143, 65, 435
"/home/david/Documents/BlackBoxRadarAttacks/FMCW_radar_uhd/src/sensing_subsystem/Eigen/src/QR/HouseholderQR_LAPACKE.h", "C++", 26, 0, 33, 10, 69
"/home/david/Documents/BlackBoxRadarAttacks/FMCW_radar_uhd/src/sensing_subsystem/Eigen/src/SPQRSupport/SuiteSparseQRSupport.h", "C++", 239, 0, 69, 28, 336
"/home/david/Documents/BlackBoxRadarAttacks/FMCW_radar_uhd/src/sensing_subsystem/Eigen/src/SVD/BDCSVD.h", "C++", 998, 0, 222, 147, 1367
"/home/david/Documents/BlackBoxRadarAttacks/FMCW_radar_uhd/src/sensing_subsystem/Eigen/src/SVD/JacobiSVD.h", "C++", 581, 0, 146, 86, 813
"/home/david/Documents/BlackBoxRadarAttacks/FMCW_radar_uhd/src/sensing_subsystem/Eigen/src/SVD/JacobiSVD_LAPACKE.h", "C++", 51, 0, 32, 9, 92
"/home/david/Documents/BlackBoxRadarAttacks/FMCW_radar_uhd/src/sensing_subsystem/Eigen/src/SVD/SVDBase.h", "C++", 207, 0, 126, 44, 377
"/home/david/Documents/BlackBoxRadarAttacks/FMCW_radar_uhd/src/sensing_subsystem/Eigen/src/SVD/UpperBidiagonalization.h", "C++", 269, 0, 84, 62, 415
"/home/david/Documents/BlackBoxRadarAttacks/FMCW_radar_uhd/src/sensing_subsystem/Eigen/src/SparseCholesky/SimplicialCholesky.h", "C++", 466, 0, 145, 87, 698
"/home/david/Documents/BlackBoxRadarAttacks/FMCW_radar_uhd/src/sensing_subsystem/Eigen/src/SparseCholesky/SimplicialCholesky_impl.h", "C++", 127, 0, 24, 24, 175
"/home/david/Documents/BlackBoxRadarAttacks/FMCW_radar_uhd/src/sensing_subsystem/Eigen/src/SparseCore/AmbiVector.h", "C++", 300, 0, 40, 39, 379
"/home/david/Documents/BlackBoxRadarAttacks/FMCW_radar_uhd/src/sensing_subsystem/Eigen/src/SparseCore/CompressedStorage.h", "C++", 209, 0, 27, 39, 275
"/home/david/Documents/BlackBoxRadarAttacks/FMCW_radar_uhd/src/sensing_subsystem/Eigen/src/SparseCore/ConservativeSparseSparseProduct.h", "C++", 275, 0, 31, 47, 353
"/home/david/Documents/BlackBoxRadarAttacks/FMCW_radar_uhd/src/sensing_subsystem/Eigen/src/SparseCore/MappedSparseMatrix.h", "C++", 34, 0, 19, 15, 68
"/home/david/Documents/BlackBoxRadarAttacks/FMCW_radar_uhd/src/sensing_subsystem/Eigen/src/SparseCore/SparseAssign.h", "C++", 204, 0, 21, 46, 271
"/home/david/Documents/BlackBoxRadarAttacks/FMCW_radar_uhd/src/sensing_subsystem/Eigen/src/SparseCore/SparseBlock.h", "C++", 427, 0, 42, 103, 572
"/home/david/Documents/BlackBoxRadarAttacks/FMCW_radar_uhd/src/sensing_subsystem/Eigen/src/SparseCore/SparseColEtree.h", "C++", 123, 0, 64, 20, 207
"/home/david/Documents/BlackBoxRadarAttacks/FMCW_radar_uhd/src/sensing_subsystem/Eigen/src/SparseCore/SparseCompressedBase.h", "C++", 242, 0, 68, 61, 371
"/home/david/Documents/BlackBoxRadarAttacks/FMCW_radar_uhd/src/sensing_subsystem/Eigen/src/SparseCore/SparseCwiseBinaryOp.h", "C++", 571, 0, 43, 109, 723
"/home/david/Documents/BlackBoxRadarAttacks/FMCW_radar_uhd/src/sensing_subsystem/Eigen/src/SparseCore/SparseCwiseUnaryOp.h", "C++", 111, 0, 8, 32, 151
"/home/david/Documents/BlackBoxRadarAttacks/FMCW_radar_uhd/src/sensing_subsystem/Eigen/src/SparseCore/SparseDenseProduct.h", "C++", 264, 0, 28, 51, 343
"/home/david/Documents/BlackBoxRadarAttacks/FMCW_radar_uhd/src/sensing_subsystem/Eigen/src/SparseCore/SparseDiagonalProduct.h", "C++", 90, 0, 19, 30, 139
"/home/david/Documents/BlackBoxRadarAttacks/FMCW_radar_uhd/src/sensing_subsystem/Eigen/src/SparseCore/SparseDot.h", "C++", 76, 0, 8, 15, 99
"/home/david/Documents/BlackBoxRadarAttacks/FMCW_radar_uhd/src/sensing_subsystem/Eigen/src/SparseCore/SparseFuzzy.h", "C++", 15, 0, 8, 7, 30
"/home/david/Documents/BlackBoxRadarAttacks/FMCW_radar_uhd/src/sensing_subsystem/Eigen/src/SparseCore/SparseMap.h", "C++", 194, 0, 67, 45, 306
"/home/david/Documents/BlackBoxRadarAttacks/FMCW_radar_uhd/src/sensing_subsystem/Eigen/src/SparseCore/SparseMatrix.h", "C++", 1028, 0, 329, 162, 1519
"/home/david/Documents/BlackBoxRadarAttacks/FMCW_radar_uhd/src/sensing_subsystem/Eigen/src/SparseCore/SparseMatrixBase.h", "C++", 241, 0, 81, 77, 399
"/home/david/Documents/BlackBoxRadarAttacks/FMCW_radar_uhd/src/sensing_subsystem/Eigen/src/SparseCore/SparsePermutation.h", "C++", 128, 0, 20, 31, 179
"/home/david/Documents/BlackBoxRadarAttacks/FMCW_radar_uhd/src/sensing_subsystem/Eigen/src/SparseCore/SparseProduct.h", "C++", 126, 0, 31, 25, 182
"/home/david/Documents/BlackBoxRadarAttacks/FMCW_radar_uhd/src/sensing_subsystem/Eigen/src/SparseCore/SparseRedux.h", "C++", 34, 0, 8, 8, 50
"/home/david/Documents/BlackBoxRadarAttacks/FMCW_radar_uhd/src/sensing_subsystem/Eigen/src/SparseCore/SparseRef.h", "C++", 300, 0, 35, 63, 398
"/home/david/Documents/BlackBoxRadarAttacks/FMCW_radar_uhd/src/sensing_subsystem/Eigen/src/SparseCore/SparseSelfAdjointView.h", "C++", 482, 0, 77, 101, 660
"/home/david/Documents/BlackBoxRadarAttacks/FMCW_radar_uhd/src/sensing_subsystem/Eigen/src/SparseCore/SparseSolverBase.h", "C++", 75, 0, 32, 18, 125
"/home/david/Documents/BlackBoxRadarAttacks/FMCW_radar_uhd/src/sensing_subsystem/Eigen/src/SparseCore/SparseSparseProductWithPruning.h", "C++", 141, 0, 31, 27, 199
"/home/david/Documents/BlackBoxRadarAttacks/FMCW_radar_uhd/src/sensing_subsystem/Eigen/src/SparseCore/SparseTranspose.h", "C++", 65, 0, 8, 20, 93
"/home/david/Documents/BlackBoxRadarAttacks/FMCW_radar_uhd/src/sensing_subsystem/Eigen/src/SparseCore/SparseTriangularView.h", "C++", 134, 0, 23, 33, 190
"/home/david/Documents/BlackBoxRadarAttacks/FMCW_radar_uhd/src/sensing_subsystem/Eigen/src/SparseCore/SparseUtil.h", "C++", 128, 0, 21, 38, 187
"/home/david/Documents/BlackBoxRadarAttacks/FMCW_radar_uhd/src/sensing_subsystem/Eigen/src/SparseCore/SparseVector.h", "C++", 332, 0, 68, 79, 479
"/home/david/Documents/BlackBoxRadarAttacks/FMCW_radar_uhd/src/sensing_subsystem/Eigen/src/SparseCore/SparseView.h", "C++", 157, 0, 56, 42, 255
"/home/david/Documents/BlackBoxRadarAttacks/FMCW_radar_uhd/src/sensing_subsystem/Eigen/src/SparseCore/TriangularSolver.h", "C++", 254, 0, 28, 34, 316
"/home/david/Documents/BlackBoxRadarAttacks/FMCW_radar_uhd/src/sensing_subsystem/Eigen/src/SparseLU/SparseLU.h", "C++", 569, 0, 251, 104, 924
"/home/david/Documents/BlackBoxRadarAttacks/FMCW_radar_uhd/src/sensing_subsystem/Eigen/src/SparseLU/SparseLUImpl.h", "C++", 47, 0, 12, 8, 67
"/home/david/Documents/BlackBoxRadarAttacks/FMCW_radar_uhd/src/sensing_subsystem/Eigen/src/SparseLU/SparseLU_Memory.h", "C++", 132, 0, 68, 27, 227
"/home/david/Documents/BlackBoxRadarAttacks/FMCW_radar_uhd/src/sensing_subsystem/Eigen/src/SparseLU/SparseLU_Structs.h", "C++", 34, 0, 69, 8, 111
"/home/david/Documents/BlackBoxRadarAttacks/FMCW_radar_uhd/src/sensing_subsystem/Eigen/src/SparseLU/SparseLU_SupernodalMatrix.h", "C++", 249, 0, 78, 49, 376
"/home/david/Documents/BlackBoxRadarAttacks/FMCW_radar_uhd/src/sensing_subsystem/Eigen/src/SparseLU/SparseLU_Utils.h", "C++", 49, 0, 20, 12, 81
"/home/david/Documents/BlackBoxRadarAttacks/FMCW_radar_uhd/src/sensing_subsystem/Eigen/src/SparseLU/SparseLU_column_bmod.h", "C++", 89, 0, 70, 23, 182
"/home/david/Documents/BlackBoxRadarAttacks/FMCW_radar_uhd/src/sensing_subsystem/Eigen/src/SparseLU/SparseLU_column_dfs.h", "C++", 88, 0, 67, 25, 180
"/home/david/Documents/BlackBoxRadarAttacks/FMCW_radar_uhd/src/sensing_subsystem/Eigen/src/SparseLU/SparseLU_copy_to_ucol.h", "C++", 53, 0, 43, 12, 108
"/home/david/Documents/BlackBoxRadarAttacks/FMCW_radar_uhd/src/sensing_subsystem/Eigen/src/SparseLU/SparseLU_gemm_kernel.h", "C++", 216, 0, 29, 36, 281
"/home/david/Documents/BlackBoxRadarAttacks/FMCW_radar_uhd/src/sensing_subsystem/Eigen/src/SparseLU/SparseLU_heap_relax_snode.h", "C++", 72, 0, 44, 11, 127
"/home/david/Documents/BlackBoxRadarAttacks/FMCW_radar_uhd/src/sensing_subsystem/Eigen/src/SparseLU/SparseLU_kernel_bmod.h", "C++", 86, 0, 30, 15, 131
"/home/david/Documents/BlackBoxRadarAttacks/FMCW_radar_uhd/src/sensing_subsystem/Eigen/src/SparseLU/SparseLU_panel_bmod.h", "C++", 132, 0, 62, 30, 224
"/home/david/Documents/BlackBoxRadarAttacks/FMCW_radar_uhd/src/sensing_subsystem/Eigen/src/SparseLU/SparseLU_panel_dfs.h", "C++", 137, 0, 86, 36, 259
"/home/david/Documents/BlackBoxRadarAttacks/FMCW_radar_uhd/src/sensing_subsystem/Eigen/src/SparseLU/SparseLU_pivotL.h", "C++", 63, 0, 62, 13, 138
"/home/david/Documents/BlackBoxRadarAttacks/FMCW_radar_uhd/src/sensing_subsystem/Eigen/src/SparseLU/SparseLU_pruneL.h", "C++", 66, 0, 58, 13, 137
"/home/david/Documents/BlackBoxRadarAttacks/FMCW_radar_uhd/src/sensing_subsystem/Eigen/src/SparseLU/SparseLU_relax_snode.h", "C++", 34, 0, 40, 10, 84
"/home/david/Documents/BlackBoxRadarAttacks/FMCW_radar_uhd/src/sensing_subsystem/Eigen/src/SparseQR/SparseQR.h", "C++", 479, 0, 195, 85, 759
"/home/david/Documents/BlackBoxRadarAttacks/FMCW_radar_uhd/src/sensing_subsystem/Eigen/src/StlSupport/StdDeque.h", "C++", 88, 0, 17, 12, 117
"/home/david/Documents/BlackBoxRadarAttacks/FMCW_radar_uhd/src/sensing_subsystem/Eigen/src/StlSupport/StdList.h", "C++", 79, 0, 15, 13, 107
"/home/david/Documents/BlackBoxRadarAttacks/FMCW_radar_uhd/src/sensing_subsystem/Eigen/src/StlSupport/StdVector.h", "C++", 99, 0, 21, 12, 132
"/home/david/Documents/BlackBoxRadarAttacks/FMCW_radar_uhd/src/sensing_subsystem/Eigen/src/StlSupport/details.h", "C++", 57, 0, 13, 15, 85
"/home/david/Documents/BlackBoxRadarAttacks/FMCW_radar_uhd/src/sensing_subsystem/Eigen/src/SuperLUSupport/SuperLUSupport.h", "C++", 750, 0, 117, 159, 1026
"/home/david/Documents/BlackBoxRadarAttacks/FMCW_radar_uhd/src/sensing_subsystem/Eigen/src/UmfPackSupport/UmfPackSupport.h", "C++", 439, 0, 94, 110, 643
"/home/david/Documents/BlackBoxRadarAttacks/FMCW_radar_uhd/src/sensing_subsystem/Eigen/src/misc/Image.h", "C++", 57, 0, 12, 14, 83
"/home/david/Documents/BlackBoxRadarAttacks/FMCW_radar_uhd/src/sensing_subsystem/Eigen/src/misc/Kernel.h", "C++", 52, 0, 14, 14, 80
"/home/david/Documents/BlackBoxRadarAttacks/FMCW_radar_uhd/src/sensing_subsystem/Eigen/src/misc/RealSvd2x2.h", "C++", 36, 0, 11, 9, 56
"/home/david/Documents/BlackBoxRadarAttacks/FMCW_radar_uhd/src/sensing_subsystem/Eigen/src/misc/blas.h", "C++", 370, 0, 2, 69, 441
"/home/david/Documents/BlackBoxRadarAttacks/FMCW_radar_uhd/src/sensing_subsystem/Eigen/src/misc/lapack.h", "C++", 128, 0, 0, 25, 153
"/home/david/Documents/BlackBoxRadarAttacks/FMCW_radar_uhd/src/sensing_subsystem/Eigen/src/misc/lapacke.h", "C++", 15567, 0, 64, 662, 16293
"/home/david/Documents/BlackBoxRadarAttacks/FMCW_radar_uhd/src/sensing_subsystem/Eigen/src/misc/lapacke_mangling.h", "C++", 14, 0, 0, 4, 18
"/home/david/Documents/BlackBoxRadarAttacks/FMCW_radar_uhd/src/sensing_subsystem/Eigen/src/plugins/ArrayCwiseBinaryOps.h", "C++", 147, 0, 181, 31, 359
"/home/david/Documents/BlackBoxRadarAttacks/FMCW_radar_uhd/src/sensing_subsystem/Eigen/src/plugins/ArrayCwiseUnaryOps.h", "C++", 313, 0, 329, 55, 697
"/home/david/Documents/BlackBoxRadarAttacks/FMCW_radar_uhd/src/sensing_subsystem/Eigen/src/plugins/BlockMethods.h", "C++", 697, 0, 637, 109, 1443
"/home/david/Documents/BlackBoxRadarAttacks/FMCW_radar_uhd/src/sensing_subsystem/Eigen/src/plugins/CommonCwiseBinaryOps.h", "C++", 41, 0, 63, 12, 116
"/home/david/Documents/BlackBoxRadarAttacks/FMCW_radar_uhd/src/sensing_subsystem/Eigen/src/plugins/CommonCwiseUnaryOps.h", "C++", 78, 0, 82, 18, 178
"/home/david/Documents/BlackBoxRadarAttacks/FMCW_radar_uhd/src/sensing_subsystem/Eigen/src/plugins/IndexedViewMethods.h", "C++", 167, 0, 53, 43, 263
"/home/david/Documents/BlackBoxRadarAttacks/FMCW_radar_uhd/src/sensing_subsystem/Eigen/src/plugins/MatrixCwiseBinaryOps.h", "C++", 61, 0, 79, 13, 153
"/home/david/Documents/BlackBoxRadarAttacks/FMCW_radar_uhd/src/sensing_subsystem/Eigen/src/plugins/MatrixCwiseUnaryOps.h", "C++", 30, 0, 54, 12, 96
"/home/david/Documents/BlackBoxRadarAttacks/FMCW_radar_uhd/src/sensing_subsystem/Eigen/src/plugins/ReshapedMethods.h", "C++", 79, 0, 51, 20, 150
"/home/david/Documents/BlackBoxRadarAttacks/FMCW_radar_uhd/src/sensing_subsystem/EnergyDetector.cpp", "C++", 1, 0, 6, 1, 8
"/home/david/Documents/BlackBoxRadarAttacks/FMCW_radar_uhd/src/sensing_subsystem/EnergyDetector.hpp", "C++", 217, 0, 116, 68, 401
"/home/david/Documents/BlackBoxRadarAttacks/FMCW_radar_uhd/src/sensing_subsystem/SensingSubsystem.cpp", "C++", 1, 0, 6, 1, 8
"/home/david/Documents/BlackBoxRadarAttacks/FMCW_radar_uhd/src/sensing_subsystem/SensingSubsystem.hpp", "C++", 228, 0, 99, 65, 392
"/home/david/Documents/BlackBoxRadarAttacks/FMCW_radar_uhd/src/sensing_subsystem/SpectrogramHandler.cpp", "C++", 1, 0, 6, 1, 8
"/home/david/Documents/BlackBoxRadarAttacks/FMCW_radar_uhd/src/sensing_subsystem/SpectrogramHandler.hpp", "C++", 801, 0, 350, 240, 1391
"/home/david/Documents/BlackBoxRadarAttacks/FMCW_radar_uhd/src/sensing_subsystem/pocketfft/LICENSE.md", "Markdown", 0, 22, 0, 4, 26
"/home/david/Documents/BlackBoxRadarAttacks/FMCW_radar_uhd/src/sensing_subsystem/pocketfft/README.md", "Markdown", 0, 198, 0, 49, 247
"/home/david/Documents/BlackBoxRadarAttacks/FMCW_radar_uhd/src/sensing_subsystem/pocketfft/pocketfft_demo.cc", "C++", 76, 0, 4, 8, 88
"/home/david/Documents/BlackBoxRadarAttacks/FMCW_radar_uhd/src/sensing_subsystem/pocketfft/pocketfft_hdronly.h", "C++", 3182, 0, 105, 297, 3584
"Total", "-", 112172, 220, 27775, 19213, 159380